###########################
#  #   #  #  #  #  #  ### #
#  #  #   #  #  #  #      #
#  #      #     #     #   #
#  ####   #  #  #  #  ### #
#  #  #      #  #  #  #   #
#     #   #  #  #    ##   #
#                         #
###########################