###########################
#  #   #  #  #  #  #  ### #
#  #  #   #  #  #  #      #
#  #      #     #     #   #
#  ####   #  #  #  #  ### #
#  #  #   #  #  #  #  #   #
#     #   #  #  #    ##   #
#                         #
###########################