###########################
#  #   #  #  #  #  #  ##  #
#  #  #   #  #  #  #      #
#  #      #     #     #   #
#  ####   #  #  #  #  ### #
#  #  #      #  #  #  #   #
#     #   #  #  #    ##   #
#                         #
##   #              #     #
#          #   #          #
#          #   #          #
##         #####          #
#                         #
###########################